2 13 31
###############################
#p * *2       *  ** * *      *#
# # # # #*# # #*# # # # # #*# #
#    * * *** **      *    **  #
# #*# # # # #3# #b#3# # # # #*#
#          *     **      *  **#
# # #*# # # # # #*#*#*#*# # # #
#   *        *   * *x* *      #
# # # # #*# # # # # # #*# #*# #
#   ****         *3           #
# # # # # # # # # #*# # # # #*#
#  ** *   *    2              #
###############################